00@@@@@@@@
@000@00@0@
@000000@0@
@000000@0@
@000@0@@0@
@00@@0000@
@000@0@@@@
@@@@@@@@@@